AAT	阿勒泰市阿勒泰机场
AKA	安康市五里铺机场
AKU	阿克苏市温宿机场
AQG	安庆市大龙山机场
AYN	安阳市安阳机场
BAV	包头市海兰泡机场
BHY	北海市福城机场
BPX	昌都市昌都马草机场
BSD	保山市保山机场
CAN	广州市白云国际机场
CGD	常德市桃花机场
CGO	郑州市新郑国际机场
CGQ	长春市大房身机场
CHG	朝阳市朝阳机场
CHW	酒泉市酒泉机场
CIF	赤峰市土城子机场
CIH	长治市王村机场
CKG	重庆市江北机场
CNI	长海市大长山岛机场
CSX	长沙市黄花国际机场
CTU	成都市双流国际机场
CZX	常州市奔牛机场
DAT	大同市怀仁机场
DAX	达州 河市霸机场
DDG	丹东市浪头机场
DIG	香格里拉 迪庆机场
DLC	大连市周水子机场
DLU	大理市大理机场
DNH	敦煌市敦煌机场
DOY	东营市东营机场
DYG	张家界市荷花机场
ENH	恩施市许家坪机场
ENY	延安市二十里铺机场
FIG	阜阳市西关机场
FOC	福州市长乐国际机场
FYN	富蕴市可可托托海机场
GHN	广汉市广汉机场
GOQ	格尔木市格尔木机场
HAK	海口市美兰国际机场
HEK	黑河市黑河机场
HET	呼和浩特市白塔机场
HFE	合肥市骆岗机场
HGH	杭州市萧山国际机场
HLD	海拉尔市东山机场
HLH	乌兰浩特市乌兰浩特机场
HMI	哈密市哈密机场
HNY	衡阳市衡阳机场
HRB	哈尔滨市阎家岗国际机场
HSN	舟山市普陀山机场
HTN	和田市和田机场
HYN	黄岩市路桥机场
HZG	汉中市西关机场
INC	银川市河东机场
IQM	且末市且末机场
IQN	庆阳市西峰镇机场
JDZ	景德镇市罗家机场
JGN	嘉峪关市嘉峪关机场
JGS	井冈山市井冈山机场
JHG	西双版纳市景洪机场
JIL	吉林市二台子机场
JIU	九江市庐山机场
JJN	泉州市晋江机场
JMU	佳木斯市东郊机场
JNZ	锦州市小岭子机场
JUZ	衢州市衢州机场
JZH	九寨沟黄龙机场
KCA	库车市库车机场
KHG	喀什市喀什机场
KHN	南昌市昌北机场
KMG	昆明市巫家坝国际机场
KOW	赣州市黄金机场
KRL	库尔勒市库尔勒机场
KRY	克拉玛依市克拉玛依机场
KWE	贵阳市龙洞堡机场
KWL	桂林市两江国际机场
LCX	连城市连城机场
LHW	兰州市中川机场
LJG	丽江市丽江机场
LNJ	临沧市临沧机场
LUM	潞西市芒市机场
LXA	拉萨市贡嘎机场
LYA	洛阳市北郊机场
LYG	连云港市白塔埠机场
LYI	临沂市临沂机场
LZH	柳州市白莲机场
LZO	泸州市萱田机场
MDG	牡丹江市海浪机场
MIG	绵阳市南郊机场
MXZ	梅县市梅县机场
NAO	南充市都尉坝机场
NAY	北京市南苑机场
NDG	齐齐哈尔市三家子机场
NGB	宁波市栎社机场
NKG	南京市禄口国际机场
NNG	南宁市吴墟机场
NNY	南阳市姜营机场
NTG	南通市兴东机场
PEK	北京市首都机场
PVG	上海市浦东机场
PZI	攀枝花 攀枝花机场
SHA	上海市虹桥机场
SHE	沈阳市桃仙机场
SHP	山海关市秦皇岛机场
SHS	荆州市沙市机场
SJW	石家庄市正定机场
SWA	汕头市外砂机场
SYM	思茅市思茅机场
SYX	三亚市凤凰国际机场
SZX	深圳市宝安国际机场
TAO	青岛市流亭国际机场
TCG	塔城市塔城机场
TEN	铜仁市大兴机场
TGO	通辽市通辽机场
TNA	济南市遥墙国际机场
TNH	通化通化机场
TSN	天津市滨海国际机场
TXN	黄山市屯溪机场
TYN	太原市武宿机场
URC	乌鲁木齐市地窝铺机场
UYN	榆林市西沙机场
WEF	潍坊市文登机场
WEH	威海市大水泊机场
WNZ	温州市永强机场
WUA	乌海市乌海机场
WUH	武汉市天河国际机场
WUS	武夷山市武夷山机场
WUX	无锡市无锡机场
WUZ	梧州市长州岛机场
WXN	万县市万县机场
XFN	襄樊市刘集机场
XIC	西昌市青山机场
XIL	锡林浩特市锡林浩特
XIY	西安市咸阳国际机场
XMN	厦门市高崎国际机场
XNN	西宁市曹家堡机场
XUZ	徐州市观音机场
YBP	宜宾市菜坝机场
YHZ	盐城市盐城机场
YIH	宜昌市三峡机场
YIN	伊宁市伊宁机场
YIW	义乌市义乌机场
YNJ	延吉市朝阳川机场
YNT	烟台市莱山机场
ZAT	昭通市昭通机场
ZHA	湛江市湛江机场
ZUH	珠海市三灶机场
ZYI	遵义市遵义机场
HKT	普吉国际机场
KIX	大阪关西国际机场
CJU	济州国际机场
YNZ	盐城南洋机场
YTY	扬州泰州国际机场
YCU	运城关公机场
TSA	台北松山机场
BKK	素万那普国际机场
ICN	仁川国际机场
WMT	遵义茅台机场
DQA	大庆萨尔图机场
GYU	固原六盘山机场
UCB	乌兰察布机场
DBC	白城长安机场
AOJ	青森机场
ULN	成吉思汗国际机场
AEB	百色巴马机场
WDS	十堰武当山机场
NRT	东京成田国际机场
LLV	吕梁大武机场
THQ	天水机场
NZL	扎兰屯机场
YVR	温哥华国际机场
NGO	中部国际机场
MFM	澳门国际机场
CGK	苏加诺-哈达机场
SIN	新加坡樟宜机场
NBS	长白山机场
HKG	香港国际机场
KUL	吉隆坡国际机场
AXF	巴彦浩特通勤机场
FUG	阜阳西关机场
LPF	六盘水月照机场
RIZ	日照山字河国际机场
AKL	奥克兰国际机场
LGW	伦敦盖特威克机场
CTS	新千岁机场
HJJ	怀化芷江机场
CXR	金兰国际机场
DMK	廊曼国际机场
DAD	岘港机场
YSQ	松原查干湖机场
DPS	巴厘岛国际机场
MDC	万鸦老国际机场
KJA	克拉斯诺尔斯克机场
AMS	阿姆斯特丹国际机场
HUO	霍林郭勒机场
SYD	悉尼金斯福德·史密斯国际机场
LHR	伦敦希思罗国际机场
HND	东京羽田国际机场
KBV	甲米国际机场
SPN	塞班国际机场
ZAZ	萨拉戈萨机场
OKA	那霸机场
HUZ	惠州平潭机场
JNG	济宁曲阜机场
JXA	鸡西兴凯湖机场
BRU	布鲁塞尔国际机场
ANC	泰德·史蒂文斯安克雷奇国际机场
DSN	鄂尔多斯伊金霍洛国际机场
JUH	池州九华山机场
REP	吴哥国际机场
BKI	亚庇国际机场
ERL	二连浩特赛乌苏国际机场
GUM	关岛国际机场
YUL	蒙特利尔特鲁多国际机场
